#....................#
#....................#
#....................#
#....................#
#....................#
#....................#
#....................#
#....................#
#....................#
#....................#
#....................#
#....................#
#....................#
#....................#
#....................#
#........................#
#........................#
#........................#
#........................#
#........................#
#........................#
#........................#
#........................#
#........................#
#.........@.....*........#
######################